15,12
0,0
0,0,0,0,0,0,0,0,0,0,0,0,0,0,0
0,0,0,0,0,0,0,0,0,0,0,0,0,0,0
0,0,0,0,0,0,0,0,0,0,0,0,0,0,0
0,0,0,0,0,0,0,0,0,0,0,0,0,0,0
0,196,197,198,0,0,0,0,0,0,0,0,0,0,0
0,212,213,214,0,0,0,0,0,0,0,0,215,216,0
0,228,229,230,0,0,0,0,0,0,0,0,231,232,0
4,0,0,0,0,0,0,0,0,0,0,0,0,0,0
20,21,0,0,0,0,0,0,0,0,0,0,0,0,0
0,115,4,0,0,0,0,0,0,0,1,2,3,4,5
0,0,20,21,0,0,0,0,0,16,17,18,19,20,21
0,0,0,115,4,0,0,0,0,32,33,0,0,36,37
